%%%%%%%%%%%%%%%%%%%%
%....%........%....%
%.%%.%.%%..%%.%.%%.%
%......GGGGG%......%
%.%.%%.%% %%%.%%.%.%
%.%....% ...%.%..%.%
%.%.%%.% %% %.%.%%.%
%.%......P....%....%
%%%%%%%%%%%%%%%%%%%%
