%%%%%%%%%%%%%%%%%%%%
%o...%...G....%...G%
%.%%.%.%%%%%%.%.%%.%
%.%..............%.%
%.%.%%.%%GG%%.%%.%.%
%G.....%GGGG%.....G%
%.%.%%.%%%%%%.%%.%.%
%.%......G.......%.%
%.%%.%.%%%%%%.%.%%.%
%G...%...P....%...o%
%%%%%%%%%%%%%%%%%%%%
