%%%%%%%%%%%%%%%%%%%%%
%G% P.%%.   .%%.. %G%
%G ....... ....... G%
%G ....... ....... G%
%%%  %%%% o %%%%  %%%
%G   ....  ....... G%
%G   ....  ....... G%
%G% ..%% .. .%%.. %G%
%%%%%%%%%%%%%%%%%%%%%
