%%%%%%%%%%%%%
%...........%
%..... .....%
%.... G ....%
%... GGG ...%
%.. GG GG ..%
%. GG o GG .%
%.. GG GG ..%
%... GGG ...%
%.... G ....%
%..... .....%
%P..........%
%%%%%%%%%%%%%