%%%%%%%%%%%%%%%%%%%%
%......%GGGG%......%
%.%%...%%GG%%...%%.%
%.%o.%........%.o%.%
%.%%.%.%%%%%%.%.%%.%
%........P.........%
%%%%%%%%%%%%%%%%%%%%
