%%%%%%%%%%%%%%%%%%%%%%%%
%........%GGGG%........%
%........%%  %%........%
%..%%......  ......%%..%
%P.%o..%........%..o%..%
%..%%..%...  ...%..%%..%
%........%%  %%........%
%........%GGGG%........%
%%%%%%%%%%%%%%%%%%%%%%%%
